# Git Aliases
alias gs="git status"
alias ga="git add"
alias gaa="git add --all"
alias gc="git commit"
alias gca="git commit --amend"
alias gco="git checkout"
alias gcb="git checkout -b"
alias gl="git log"
alias glg="git log --oneline --graph --decorate"
alias gpl="git pull"
alias gps="git push"
alias gb="git branch"
alias gbd="git branch -d"
alias gup="git fetch --all && git merge origin/$(git symbolic-ref --short HEAD)"
alias grb="git rebase"
alias gcl="git clone"
alias gdiff="git diff"

# Docker Aliases
alias d="docker"
alias dps="docker ps"
alias dpsa="docker ps -a"
alias di="docker images"
alias drm="docker rm"
alias dprune="docker system prune"
alias dbuild="docker build -t"
alias drun="docker run -it"
alias dexec="docker exec -it"
alias dlogs="docker logs -f"
alias dbash="docker exec -it $1 bash"
alias dstop="docker stop"
alias drmi="docker rmi"
alias dpsall="docker ps -q | xargs docker stop | xargs docker rm"

# macOS Aliases
alias ..="cd .."
alias ...="cd ../.."
alias ~="cd ~"
alias docs="cd ~/Documents"
alias desktop="cd ~/Desktop"
alias downloads="cd ~/Downloads"
alias open="open ."
alias cls="clear"
alias c="clear"
alias h="history"
alias j="jobs"
alias p="pwd"
alias sd="say 'done'"
alias path="echo $PATH"

# Directory Navigation Aliases
alias ..="cd .."
alias ...="cd ../.."
alias ....="cd ../../.."
alias ~="cd ~"
alias d="cd ~/Documents"
alias b="cd ~/Desktop"
alias c="cd ~/Projects"
alias code="cd ~/Projects/Code"
alias public="cd ~/Public"
alias h="cd ~"
alias sd="cd /var/www"
